{
    "map": [
        [1,1,1,1,1,1,1,1,1,1],
        [1,0,0,0,0,0,0,0,0,1],
        [1,0,0,0,0,0,0,0,0,1],
        [1,0,0,1,1,1,1,0,0,1],
        [1,0,0,1,0,0,0,0,0,1],
        [1,0,0,1,1,1,1,0,0,1],
        [1,0,0,0,0,0,0,0,0,1],
        [1,0,0,0,0,0,0,0,0,1],
        [1,0,0,0,0,0,0,0,0,1],
        [1,1,1,1,1,1,1,1,1,1]
    ],
    "player": {"x":5, "y":4},
    "objects": [],
    "enemies": []
}